////////////////////////////////////////////////////////////////////////////////////////////////////
////////////////////////////////////////////////////////////////////////////////////////////////////
///////@@@//////////////////////////////////////////////////////////////////////////////////////////
/////@@@@@//////////////////////////////////////////////////////////////////////////////////////////
/////@@@@@@@@///////////////////////////////////////////////////////////////////////////////////////
///////@@@@@@@//////////////////////////////////////////////////////////////////////////////////////
///////@@@@@@@@/////////////////////////////////////////////////////////////////////////////////////
/////////@@@@@@/////////////////////////////////////////////////////////@@@@@@@@@@@@////////////////
//////////@@@@@@@@@//////////////////////////////////////@@@@@@@@@@@@@@@@@@@@@@@@@@@@@@/////////////
///////@@@@@@@@@@@@@@@@///////////////////////////////////@@@@@@@@@@@@@@@@@@@@@@@@@@@@@@////////////
////////@@@@@@@@@@@@@@@@/////////////////////////////////////@@@@@@@@@@@@@@@@@@@@@@@@@@@@///////////
/////////@@@@@@@@@@@@@@@//////////////////////////////////////@@@@@@@@@@@@@@@@@@@@@@@@@@@@@/////////
//////@@@@@@@@@@@@@@@///////////////////////////////////////////////@@@@@@@@@@@@////////////////////
/////@@@@@@@@@@@@@@@@@@@@@/////////////////////////////////////////////@@@@@@@//////////////////////
////@@@@@@@@@@@@@@@@@@@@@@@/////////////////////////////////////////////@@@@@///////////////////////
//@@@@@@@@@@@@@@@@@@@@@@@@@@/////////////////////////////////////////////@@@////////////////////////
///@@@@@@@@@@@@@@@@@@@@@@@@////////////////////////////////////////////@@@@@@///////////////////////
////@@@@@@@@@@@@@@@@@@@@@/////////////////////////////////////////////@@@@@@@@@@@///////////////////
//////@@@@@@@@@@@@@@@@@@@@@@///////////////////////////////////////@@@@@@@@@@@@@@@@/////////////////
////@@@@@@@@@@@@@@@@@@@@@@@@@@@/////////////////////////////////////@@@@@@@@@@@@@@@@@@//////////////
/////@@@@@@@@@@@@@@@@@@@@@@@@@@@@/////////////////////////////////@@@@@@@@@@@@@@@@@/////////////////
/////@@@@@@@@@@@@@@@@@@@@@@@@@@@@@@@@@@@////////////////////@@@@@@@@@@@@@@@@@@@@@@@@////////////////
////@@@@@@@@@@@@@@@@@@@@@@@@@@@@@@@@@@@@@///////////////////////@@@@@@@@@@@@@@//////////////////////
//@@@@@@@@@@@@@@@@@@@@@@@@@@@@@@@@@@@@@@@///////////////////@@@@@@@@@@@@@@@@@@@@@///////////////////
///@@@@@@@@@@@@@@@@@@@@@@@@@@@@@@@@@@@@@@@////////////////////@@@@@@@@@@@@@@@@//////////////////////
/////@@@@@@@@@@@@@@@@@@@@@@@@@@@@@@@@@@@@@@@@@//////////////@@@@@@@@@@@/////////////////////////////
//////////@@@@@@@@@@@@@@@@@@@@@@@@@@@@@@@@@@@@@@@@@@@@@@@@@@@@@@@@@@@@@@@///////////////////////////
//////////////////@@@@@@@@@@@@@@@@@@@@@@@@@@@@@@@@@@@@@@@@@@@@@@@@@@@@@@@@@@////////////////////////
///////////////@@@@@@@@@@@@@@@@@@@@@@@@@@@@@@@@@@@@@@@@@@@@@@@@@@@@@@@@@@@@@@@@/////////////////////
///////////@@@@@@@@@@@@@@@@@@@@@@@@@@@@@@@@@@@@@@@@@@@@@@@@@@@@@@@@@@@@@@@@@@@@@@@@/////////////////
/////////@@@@@@@@@@@@@@@@@@@@@@@@@@@@@@@@@@@@@@@@@@@@@@@@@@@@@@@@@@@@@@@@@@@@@@@@@@@@@//////////////
///////@@@@@@@@@@@@@@@@@@@@@@@@@@@@@@@@@@@@@@@@@@@@@@@@@@@@@@@@@@@@@@@@@@@@@@@@@@@@@@@//////////////
/////@@@@@@@@@@@@@@@@@@@@@@@@@@@@@@@@@@@@@@@@@@@@@@@@@@@@@@@@@@@@@@@@@@@@@@@@@@@@///////////////////
////////////////////////////////////////////////////////////////////////////////////////////////////
////////////////////////////////////////////////////////////////////////////////////////////////////
